IEEKEEEKEEEEEEEJ
G  G   R      TG
G TG      PEEEEN
G  G   Q S   S G
G  G   G   S   G
G  FO  FEEEEEEEN
G S   T S   S  G
MO  IEEEEEEO   G
G   G S   S T  G
G  SG   IEJ  S G
G   G S G G    G
G   G   FEH S  G
GS  G  S   S  TG
G   FEEEEEEEEEEN
GT S    S S  T G
FEEEEEEEEEEEEEEH
